111111111111
1P0000000001
100000000001
10001C010001
101101010001
101000010001
101111110001
1000000000E1
111111111111