1111111111
1P1001C001
101C010101
10110001C1
10C001C111
11110111E1
100001C101
1011000101
1C1C01C001
1111111111