111111111111111111111
100010000000100000001
1P011000C100100000001
100C100001000C1101111
1001100011111000010E1
1000000000C0000000001
111111111111111111111