1111111111111
1P01000100011
1100010001001
1111111111101
1E10001C00101
1000100010001
1111111111111