111111111111111111
100000000000000001
100001111100100001
100011000000100001
100011000000100001
10001100000010C001
10001100001110C001
1P01100000E1000001
111111111111111111