111111111111111111
100000000000000001
100001111100100001
100011000000100001
100011000000100001
10001100000010C001
10001100000110C001
1P001100000E100001
111111111111111111