11111111111111111111111
100000000C1E1C000000001
10111000111011100011101
101C001000000000100C101
10111C10111011101C11101
100C01C0000P0000C10C001
11111111111111111111111