1111111111111111111111111111111111111
1000100C1000100010001000100010C010001
1010101010101010101010101010101010101
10000000000000C00000000000C0000000001
101C1010101010101010101010101010101P1
10001000100010001000100010C0100010001
1010101010101010101010101011101010101
1000000C00000000C000000000C0000000001
101010101010101C101010101010001010101
10E01000100010001000100010001C0010001
1111111111111111111111111111111111111